randomness - случайность
However - тем не мение
UNIFIED - единый
APPROACH - подход
to separate - разделять
meaningful - значимый
comparison - сравнение
impede - препятствовать
manuscript - рукопись
state-space model - модель пространства состояний
betting market - рынок ставок
uniformly - равномерно
game outcomes - исход игры
extract - извлечь
estimate - оценить
between-season - межсезонье
within-season - сезон
game-to-game - от игры к игре
variability - изменчивость
implement - воплощать в жизнь
decade - десятилетие
relative - относительный случай
conclude - сделать вывод, заключить
competitiveness - конкурентноспособность
judging - судя
harmlessly - безобидно
discuss - обсудить
generalizable - обобщаемый
observer - наблюдатель
extent - степень
miraculously - чудесным образом
line drive - 
influence - влияние
perceptions - восприятие



